SSSSSSSSSSSSSSSSSSSSSSSSS
SPOOOOOOOOOOOOOOOOOOOOOOS
SOSSOSSOSOOSSSSSSSOSSSSOS
SOOOOOOOSOOOOSOOOSOSOSOOS
SOSOSOSOSOSSOSOSOSOSOSSOS
SOOOOOOOSOOOOOOOOSOSOOOOS
SOSOSOSOSSSSOOSOOSOSSSSOS
SOOOOOOOSSOOOOSOSSOSOOOOS
SOSSSSSSSSOOOOSOOsOSOOOOS
SOOOOOOSOSOOSOSSOSOSOOOOS
SSSSSSOSSSSSSOOOOSOSOOOOS
SOOOOOOSOOOOSOSOSSOSOOOOS
SOOOOOOSOSSOSOOOOSOSOOOOS
SOOOOOOSOSSOSSSSOSOSOOOOS
SOOOOOOSOOOOOOOOOOOSOOOOS
SOSOOOOSOSSSSSSSSSOSOOOOS
SOSOOOOOOOOOOOOOOOOSOOOOS
SOSSSSSSOSSSSSOSSSSOOOOOS
SOOOOOOOOOOOOOOOOOOSOOOOS
SOOOOOOOOOOOOOOOOOOSOOOOS
SOOOOOOOOOOOOOOOOOOSOOOOS
SOOOOOOOOOOOOOOOOOOSOOOOS
SOOOOOOOOOOOOOOOOOOSOMOSS
SOOOOOOOOOOOOOOOOOOSOOOSS
SMOOOOOOOOOOOOOOOOOOOOOSS
SSSSSSSSSSSSSSSSSSSSSSSSS