SSSSSSSSSSSSSSSSSSSSSSSSS
SPOOOOOOOOOOOOOOOOOOOOOOS
SOSSOSSOSOOSSSOSSSSSSSSOS
SOOOOOSOSOOOOSOOOOOOOOOOS
SOSOSOSOSOSSOSOSOSOSOSSSS
SOSOOOOOSOOOOOOOOSOOOOOOS
SOSSOSSOSSSSOOSOOOOOSOSOS
SOOOOOOOOOOOOOSOSSSSSOSOS
SOSSSSSSSSOSSOSOOsOOSOSOS
SOOOOOOOOOOOOOSSOSOOOOOOS
SSSSSSOSSSSSSOOOOSOOSOSOS
SOOOOOOSOOOOSOSSSSOOSOSOS
SOSSSSOSOSSOSOOOOSOOSOSOS
SOOOOSOSOSSOSSSSOSOOOOSOS
SOOSOSOSOOOOOOOOOOOOOOSOS
SOSOOSOSOSSSSSSSSSSOSOSOS
SOSOOOOOOOOOOOOOOOOOSOSOS
SOSSSSSSOSSSSSOSSOSOSOOOS
SOOOOOOOOOOOOOOSSOSOSSSOS
SOSSSSOSSSSSSSSSOOOMOOOOS
SOOOOSOSOOOSOOOSOOSOSSSOS
SOSSOOOSOSOSOSOSOSSOSOOOS
SOOOSSSSOSOSOSOSOOSOSOSOS
SOOOOOOOOOOOOSOOOOOOOOOOS
SSSSSSSSSSSSSSSSSSSSSSSSS