SSSSSSSSSSSSSSS
SPOOOSOOOOOOOOS
SOOOOSOSSSSOSOS
SOSOSSOOOSOOOOS
SOSOOOOSOOOSSSS
SOSSOSSSOSOSOOS
SOOOOOOOOSOSOOS
SOSSOSOSOOOSSOS
SOOOOSOOOSSSOOS
SOSOOOOSOSOOOSS
SOSSOSSSOOOSOOS
SOOOOOOOOSOOOOS
SOSSOSOSOSOSSOS
SOOOOSOOOOOOOMS
SSSSSSSSSSSSSSS