SSSSSSSSSS
SPOOOSOOOS
SOOOOSOSOS
SOSOSSOOOS
SOSOOOOSOS
SOSSOSSSOS
SOOOOOOOOS
SOSSOSMSOS
SOOOOSOOOS
SSSSSSESSS