SSSSSSSSSSSSSSSSSSSS
SOOOOOOOOOOOOOOOOOOS
SOSOOSOOSOSSOSOSMSOS
SOOOSSSOSOSSOSOSOOOS
SOSPSOOOSOOOOOOSSSOS
SOSOSOSSSSSSOOSOOOOS
SOOOOOSSOOOOOOSOSOOS
SOSSSSSSOSSOSOOOOSSS
SOOOOOOOOOOOSOSSOOOS
SSSOSSOSSOSSSOOOOOOS
SOOOOOOSOOOOSOSOSSOS
SOOOOSOSOSSOSOOOOSOS
SOSSSSOSOSSOSSSSOOOS
SOSOOOOSOOOOOOOOOSOS
SOSOSOOSOSSSSOSSSSOS
SOOOOOOOOOOOOOOOOOOS
SOSSSSOSOOSSSSSOSSSS
SOSOOOOSOOOOSOOOOOOS
SMOOSSOOOSSOOOOSOMOS
SSSSSSSSSSSSSSSSSSSS